words:
DuKo   |dog
DuKu   |dogs
MiRo   |cat
MiRu   |cats
KuDu   |take,took,grab,select,pick
KuDi   |give,store
Mi     |I,me
MiDi   |we,us
Di     |they,them,that,their
DiRe   |there
DiRa   |that(for syntax)
DuRo   |what
DuRu   |whats
MiRi   |hi,hello
DeKo   |do
DeKu   |does
DeKi   |did
DiKu   |hide,fall,down,shortend,minus(-),close,low,less,single
DiRu   |show,rise,up,extended,plus(+),open,high,more,multi
RiDo   |the,an,it,a
RiDu   |it's,as
NuLi   |no,false,bad
NaLi   |yes,true,good
RiKu   |to,in,at
RiSo   |go,start,join
RiSu   |goto,goes,going
RiDi   |got,started,joined
KiNo   |fox
KiNu   |foxes
kaKo   |house
kaKu   |houses
Si     |if
Ri     |else,other
SiSo   |end,stop,leave
SiRu   |male,boy,he
SiRa   |female,girl,she
Shia   |come on
RaSo   |propose
RaSu   |proposes
RaSi   |known,knowned as
RaSe   |now
SuKo   |work,process
SuKu   |working,processing
RiNo   |task
RiNu   |tasks
NuKu   |run
RiRa   |same
RiRi   |similar
RiRo   |diffent,not the same thing
RiRu   |diffents
KuRo   |language
KuRu   |languages
NaRa   |voice
NoKo   |chat
NoKu   |chating
SuRa   |sex
RuSo   |have
RuSu   |have'd
RuSi   |says "fishy" really means "fish"
KuRa   |thank
Ni     |you
NiBa   |your
Nu     |wow,heh
Na     |cool,nice
RiKa   |play
RiKi   |fun
NiKo   |luck
NiKu   |lucky
KuKa   |game
NaNo   |system
NaNu   |systems
NaNi   |technology
NaRo   |bye
NaRu   |bye-bye
RiNa   |varible
NaRa   |math,arithmetic
NaRi   |number
RiNi   |string
NuRi   |and,with
KuNa   |advanced,powerful
NaKo   |electronic,digial
NaKu   |electronics
RaRo   |call
RaRu   |calling
RaRa   |called
NiLa   |mean
NiRo   |program
NiRu   |programing
NiNi   |done
NiNo   |back
NiNu   |backs-up(walking backwards)
NiKi   |main
NiRa   |menu
Ka     |all
Ke     |none
KeKi   |unload
KeKo   |load,read
KeKu   |loading,reading
KaNo   |save,set
KaNe   |saved,setted
KaNu   |saving,setting
KiKe   |planet,world
La     |0
Li     |1
Lo     |2
Lu     |3
LaLa   |4
LiLa   |5
LoLa   |6
LuLa   |7
LaLi   |8
LiLi   |9
LoRi   |network
LuRi   |internet
LuKa   |settings,options
RiLo   |save
RiLu   |saving
RiLi   |summon,spawn
RiLa   |resummon,respawn
NaRa   |sorry
NiRo   |story
NiRu   |stories
NiRa   |town
NiRi   |city
NaRiKo |human
NaRiKu |humans
KaRiNi |earth
KiNe   |Therefore,other words
KaNi   |say,speak
KaNa   |speech,paragraph
KaNiRa |said,spoke
RaKo   |move,switch
RaKu   |moved,switched
RaKe   |moving,switching
LoRa   |north,up
LoRi   |south,down
LiRa   |east,right
LiRi   |west,left
LuRa   |land,area,space
LuKo   |camp
LuKu   |camps
LaRi   |before,early
LaRa   |after,late
RaKaLo |make
RaKaLu |making
RaKaLe |made
RiKiLo |brick
RiKiLu |bricks
RiKiRo |stone
RiKiRu |stones
RoLo   |build
RoLu   |building
RoLi   |buildings
Rulo   |tall
Rulu   |taller
LuRaKa |top
LuRaKi |bottem
RaNaKi |sky
NoRo   |bunny
NoRu   |bunnys
NuKuLo |fluffle
kiKo   |cake
kiKu   |cakes
Naka   |but
BoKu   |flower,floran,nature,tree,plant
KiMo   |Money,Currency
KiBo   |coin
KiBu   |coins
NiMo   |Where
NiMu   |Whereâ€™s
BoKi   |wear(put on/have on)
NuRa   |people
BoRo   |see
BoRu   |sees
BoRi   |water
BuRi   |lava
BoNa   |push
BoNo   |love
BoNu   |loves
BoNi   |pull
Bi     |can(not a real can)
Bo     |park
Bu     |parks
Ba     |eat
MiRa   |help,info
BiKi   |food
BoKo   |theme
BoKu   |themes
BoKa   |song
BoNi   |act
GuRo   |warrior
GuRu   |warriors
GuRi   |weapon
GuRa   |attack
GoRo   |friend
GoRu   |friends
GuKaRa |WAR
GaKi   |translate
GaKo   |compare
GaKu   |compares
RiGa   |mean(like i mean something)
RiGi   |like
ReGi   |dislike
RaGo   |pizza
RaGu   |pizza(s)
RiGo   |test
RiGu   |tests,testing
GaLa   |HOT
GaLaKi |COLD
GaRi   |fire
GaRe   |ice
GuRe   |dry
GuRi   |wet
GuRo   |acid
GuRu   |acids
RuGo   |poke,ask
RuGu   |pokes,asks
RuNa   |monster
NeRo   |let
NeRu   |lets
GoRi   |set,is,like,equal(=),as,set as
GoRe   |life,live
RiRe   |rotate
NeRe   |left
NaRe   |right
ReKa   |toilet,potty
ReKiKa |problem
ReKi   |common,standerd
ReNo   |step
ReNu   |basics
ReGo   |pro
ReGu   |pros
GeNe   |party
GuNa   |found
GuNo   |each,another
GuNu   |others,anothers
GaKuBa |bake
KaBo   |use
KaBu   |uses
KaBe   |used
BeRi   |instead of
BuRaKi |tar
BuRaKa |oil
BuRaKe |gas
BuRo   |line
BuRu   |lines
RiBo   |heaven
RiBu   |heavens
BiRi   |name
BeDo   |way
BeDu   |ways
BiDa   |of(for syntax)
BiDe   |for(for syntax)
BiDi   |as(for syntax)
BaDo   |to(for syntax)
BaRu   |from(for syntax)
BeRo   |be(for syntax)
KaBaKo |split
KaBaKu |splitting
KaBaKi |splitted
BaRa   |across 
BaRi   |over
BaBi   |the(!)
GaBa   |warning
GaDa   |translation
BaGe   |undo
BaGa   |redo
BaKa   |copy,clone,duplicate
BaKi   |paste
SiBa   |code
SeKa   |random
SeKo   |cheat
SeKu   |cheats
SeKe   |cheating
SeRo   |custom
SeRu   |customize
SeRi   |customble
SeBo   |share
SeBu   |sharing
BaSe   |box
KaSi   |some,(a)few
KeSiRa |mode
KeMaRi |survival
KeMaRe |creative
KeMaRa |Spectator
KeMaRo |adventure
KeMaRu |HARDCORE adventure
BuRo   |fool,stupid,idiot
BuRu   |dummy
BaKaKo |teach
BaRaKu |teaching
BaKiKo |learn
BaKiKu |learning
BoKiKa |owner
BoKiKe |work
BoKaRi |boss
BoKaRo |idea,plan
BoKaRu |ideas,plans
BoKaRe |sound
BoKaRa |video(image)
LoKaBa |mad
LuBiRa |happy
LoBaKa |slow
LoBaKi |fast
LeRi   |light
LeRa   |need
LoRiKa |health
LoRiKo |hunger
LoRiKu |hungry
BoKaRi |lord
LaKiRa |came
BoGa   |are(for syntax)
NeGa   |withheld
NaRiGo |confuse
NaRiGu |confuses
NaRiGi |confused
NaReGo |understand
NaReGu |understands
Ne     |not
NeRa   |because
LaNeLo |sick
LaNeLu |virus
LaNaLo |cure
LaNaLu |antidote
MiRe   |data,file
KaLi   |ok,alright,fine
MiRiLo |random
MiKaRi |access
MiLeKa |memory 
MiRaNa |central,middle
MiDoKa |unit,component
KiNa   |chip,circuit(also `circuit chip`)
KiRa   |here
RuRa   |cute
RuRe   |like
KhiKa  |explain,details
ShaKu  |why
KiKi   |action
KiKiRa |sit
KiKiRi |lay
KiKiRo |obey
KiKiRu |obeys
KiKiRa |walk
KiKiRe |think
Shi    |when
Sha    |how
Sho    |toy
Shu    |toys
She    |board
PaKa   |better
BaPa   |worse
BaRaShi|unknown
KuBaRa |trouble,problem
KuRaBa |score
KaBa   |time
KiBe   |date
KaBaRo |day,morning
KaBaRu |night,evening
KaBaRi |noon
KiBa   |will
KiRe   |treat
KeBa   |friut
KeBi   |vegetable
NaBu   |would
MaKiRa |never
MoKiRi |always
MiKi   |in
MiKo   |out
NaKi   |mm.
NaKa   |cm.
NaKoRi |inch
NaKuRi |feet
NaShi  |yard
NaKe   |mile
NeKi   |ms.
NeKo   |sec.
NeKu   |min.
NeKa   |hour
NeRi   |day
NeNa   |week
NeNe   |month
NeNi   |year
PuTiKa |recording
PuTiKo |playback/play
PuTiKu |plays
PuTiKi |winding
MiNo   |forward
PhaRi  |idle
ShaKi  |cover,lid
ShiKo  |window
ShiKu  |windows
SheKo  |door
SheKu  |doors
PiNe   |location,spot
ShiNa  |VIP
PeKa   |title
DeKa   |sun
DePa   |moon
BaShiKu|Dynamic
